WE ./Users/dbaron/Desktop/cub3d/textures/pink.xpm
F  156, 30, 111
C   57, 219, 89
S                   ./Users/dbaron/Desktop/cub3d/textures/bong.xpm
R   5000 5000
NO     ./Users/dbaron/Desktop/cub3d/textures/blue.xpm
SO    ./Users/dbaron/Desktop/cub3d/textures/green.xpm
EA    ./Users/dbaron/Desktop/cub3d/textures/purple.xpm


                        1111111111111111111111111
                        1000000000110000000000001
                        1011020001110000002000001
                        1001000000000000000022001
                11111111011000001110000000N000011
                100000000011000001110111110111111
                11110111111111011100000010001
                11110111111111011101010010001
                11000000110101011100000010001
                10000000000000001100000010001    
                10000000000000001101010010001
                1000000111010101111101111000111
                11110111 1110101 101111010001
                11111111 1111111 111111111111
        